6 9
WWWWWW
W00F0W
WS00aW
WWWAWW
WW00bW
WW000W
WWWBWW
WWG00W
WWWWWW